NO ./textures/NO.xpm
SO ./textures/SO.xpm
WE ./textures/WE.xpm
EA ./textures/EA.xpm

F 220,100,0
C 225,30,0


111111111111
100000000001
100000000001
100000000001
100000000001
100000N00001
100000000001
100000000001
100000000001
100000000001
100000000001
111111111111