111111
100001
1000P1
100001
100001
111111