NO ./textures/NO.xpm
SO ./textures/EA.xpm
WE ./textures/EA.xpm
EA ./textures/EA.xpm

F 100,100,0
C 200,200,0

   111111
   100011
10010111
101001
1100N1
111111