NO ./textures/NO.xpm

SO ./textures/EA.xpm

WE ./textures/EA.xpm

EA ./textures/EA.xpm

F 100,100,0
C 200,200,0, 23



        1111111111111111111111111
        1000000000110000000000001
        101100000111000000000001
         1000000000000000000001
11111111101100000111000000000001
100000000011000001110111110111111
11110111111 111011100000010001
11110111111 11011101010010001
11000000110101011100000010001
10000000000000001100000010001
1000000000000000110101010001
11000001110101011111011110W0111
11110111 1110101 101111010001
1 111111 1111111 111111111111



