NO ./textures/NO.xpm
SO ./textures/SO.xpm
WE ./textures/WE.xpm
EA ./textures/EA.xpm

F 100,100,0
C 200,200,0

11111111111111111111111111111111111111111111111111111111111111111111111111111111111111111
10000000000000000000000000000000000000000000000000000000000000000000000000000000000010101
10000000000000000000000000000000000000000000000000000000000000000000000000000000000010101
10000000000000000000000000000000000000000000000000000000000000000000000000000000000010101
10000000000000000001010111111111111111111111111111111111111111111111111111111111111111111
100000000000000000010101
100000000000000000010101
100000000000000000010101
100000000000000000010101
100000000000000000010101
100000000000000000101011
100000000000000000010111
1000000000011000000000N1
100000000001100000000001
100000000001100000100001
100000000000000001010001
111111111111111111111111



