NO ./textures/NO.xpm
SO ./textures/SO.xpm
WE ./textures/WE.xpm
EA ./textures/EA.xpm

F 2,158,7
C 82,223,255

111111111111111111111111
100000000000000000000011
10000000000000000000000111111111111
100000000000000000000000000000000001
10000000000000000001010111111111111
100000000000000000010101
100000000000000000010101
100000000000000000010101
100000000000000000010101
100000000000000000010101
100000000000000000101011
100000000000000000010111
1000000000011000000000N1
100000000001100000000001
100000000001100000100001
100000000000000001010001
111111111111111111111111



