111111
101001
1010P1
100001
100001
111111