NO ./textures/NO.xpm

SO ./textures/EA.xpm

WE ./textures/EA.xpm

EA ./textures/EA.xpm

F 100,100,0
C 200,200,0

111111111111111111111111
100000000000000000010101
100000000000000000010101
100000000000000000010101
10000000000110000000N001
100000000001100000000001
100000000001100000000001
100000000000000000000001
11111111111111111111111