NO ./textures/NO.xpm
SO ./textures/SO.xpm
WE ./textures/WE.xpm
EA ./textures/EA.xpm

F 220,100,0
C 225,30,0


        111111111111
        100000000011
        101100000111
        1N0100000001
1111111100100000111
11111111111111111111